┌────────────┐┌───────────────────────────────────────────────────┐┌───────────────────────────────────────────────────┐
│First column││Two                                                ││Three                                              │
│            ││                                                   ││                                                   │
│            ││                                                   ││                                                   │
│            ││                                                   ││                                                   │
│            ││                                                   ││                                                   │
└────────────┘└───────────────────────────────────────────────────┘└───────────────────────────────────────────────────┘
┌────────────┐┌───────────────────────────────────────────────────┐┌───────────────────────────────────────────────────┐
│Four        ││Five                                               ││Six                                                │
│            ││                                                   ││                                                   │
│            ││                                                   ││                                                   │
│            ││                                                   ││                                                   │
│            ││                                                   ││                                                   │
│            ││                                                   ││                                                   │
│            ││                                                   ││                                                   │
│            ││                                                   ││                                                   │
│            ││                                                   ││                                                   │
│            ││                                                   ││                                                   │
│            ││                                                   ││                                                   │
│            ││                                                   ││                                                   │
│            ││                                                   ││                                                   │
│            ││                                                   ││                                                   │
│            ││                                                   ││                                                   │
│            ││                                                   ││                                                   │
│            ││                                                   ││                                                   │
│            ││                                                   ││                                                   │
│            ││                                                   ││                                                   │
│            ││                                                   ││                                                   │
│            ││                                                   ││                                                   │
└────────────┘└───────────────────────────────────────────────────┘└───────────────────────────────────────────────────┘
