┌──────────────────────────────────────┐┌──────────────────────────────────────────────────────────────────────────────┐
│One                                   ││Two (column-span: 2 and row-span: 2)                                          │
│                                      ││                                                                              │
│                                      ││                                                                              │
│                                      ││                                                                              │
│                                      ││                                                                              │
│                                      ││                                                                              │
│                                      ││                                                                              │
│                                      ││                                                                              │
└──────────────────────────────────────┘│                                                                              │
┌──────────────────────────────────────┐│                                                                              │
│Three                                 ││                                                                              │
│                                      ││                                                                              │
│                                      ││                                                                              │
│                                      ││                                                                              │
│                                      ││                                                                              │
│                                      ││                                                                              │
│                                      ││                                                                              │
│                                      ││                                                                              │
└──────────────────────────────────────┘└──────────────────────────────────────────────────────────────────────────────┘
┌──────────────────────────────────────┐┌──────────────────────────────────────┐┌──────────────────────────────────────┐
│Four                                  ││Five                                  ││Six                                   │
│                                      ││                                      ││                                      │
│                                      ││                                      ││                                      │
│                                      ││                                      ││                                      │
│                                      ││                                      ││                                      │
│                                      ││                                      ││                                      │
│                                      ││                                      ││                                      │
│                                      ││                                      ││                                      │
└──────────────────────────────────────┘└──────────────────────────────────────┘└──────────────────────────────────────┘
