┌────────────────────────────────────────────────────────────────────────────────────────────────────────────────────┐
│One                                                                                                                 │
│                                                                                                                    │
│                                                                                                                    │
│                                                                                                                    │
│                                                                                                                    │
│                                                                                                                    │
│                                                                                                                    │
│                                                                                                                    │
│                                                                                                                    │
│                                                                                                                    │
│                                                                                                                    │
│                                                                                                                    │
└────────────────────────────────────────────────────────────────────────────────────────────────────────────────────┘
┌────────────────────────────────────────────────────────────────────────────────────────────────────────────────────┐
│Two                                                                                                                 │
│                                                                                                                    │
│                                                                                                                    │
│                                                                                                                    │
│                                                                                                                    │
│                                                                                                                    │
│                                                                                                                    │▄▄
│                                                                                                                    │
│                                                                                                                    │
│                                                                                                                    │
│                                                                                                                    │
│                                                                                                                    │
└────────────────────────────────────────────────────────────────────────────────────────────────────────────────────┘
┌────────────────────────────────────────────────────────────────────────────────────────────────────────────────────┐
│Three                                                                                                               │
