┌──────────────────────────────────────┐┌──────────────────────────────────────────────────────────────────────────────┐
│One                                   ││Two (column-span: 2)                                                          │
│                                      ││                                                                              │
│                                      ││                                                                              │
│                                      ││                                                                              │
│                                      ││                                                                              │
│                                      ││                                                                              │
│                                      ││                                                                              │
│                                      ││                                                                              │
└──────────────────────────────────────┘└──────────────────────────────────────────────────────────────────────────────┘
┌──────────────────────────────────────┐┌──────────────────────────────────────┐┌──────────────────────────────────────┐
│Three                                 ││Four                                  ││Five                                  │
│                                      ││                                      ││                                      │
│                                      ││                                      ││                                      │
│                                      ││                                      ││                                      │
│                                      ││                                      ││                                      │
│                                      ││                                      ││                                      │
│                                      ││                                      ││                                      │
│                                      ││                                      ││                                      │
└──────────────────────────────────────┘└──────────────────────────────────────┘└──────────────────────────────────────┘
┌──────────────────────────────────────┐
│Six                                   │
│                                      │
│                                      │
│                                      │
│                                      │
│                                      │
│                                      │
│                                      │
└──────────────────────────────────────┘
